###############
#.....#.......#
#.###.#######.#
#.#.#...#.....#
#.#.###.#.#####
#...#...#.....#
#####.#######.#
#.#...#...#...#
#.#.###.#.#.###
#.......#.....#
#.###########.#
#.........#...#
#########.#.###
#.........#...#
###############

